2100010001
0000100001
0000011000
0100000000
0100000000
0100003001
1110011100
0000000000
0000010110
0000000000
