2001011001
0100000100
1100110000
0110000000
0000001000
1100100011
1110011031
1001001001
1111100110
0100110010
