2000100000
0001100000
0000000000
0011000000
0000000000
0000000000
0000003000
0000000000
1010010100
1000000000
