200100000000010010000000000000
000010000010000000000000010100
000000000001000000000000000000
000000101000000000000000000000
000000010000000000000010000000
000000100010000000000010001001
000100000000100100100000000000
000000000001000000010000001000
000101000000000010000100000000
000000000000000000100010000000
010000000000100000000010100000
000000000000000000000110010000
000100000000000001000000010100
000000000000000000000010000000
000100001000100010000000010101
000000000000000010000000000010
000000000000100000000000000000
000000000000000000001100000000
000000000100000000000000000000
000001000000100000000000000001
000000000000010000000000100000
000101000010000000000000000000
000000010000000000110000000000
000000001000000001000000000000
100000000000000000100000100000
001000000010001011000000000110
100101010000100000000000000000
000000000000000000010000000100
010000010000000100000000000001
000000000000000000000030000010
