2100100000
1000010101
1011100100
1101100011
1011101000
0001000113
0001100100
0100101001
0111010000
0011000110
