2101100000
0001111100
1000010010
0011110000
0011101000
0011011100
1000011000
0101101000
0010031001
0111100011
