2000010010
0111011011
1001000010
0110011000
1001100100
0010100001
0101100000
0101110003
1100111110
0100101000
