200000000000001000000000000100
000010000000100000100000100000
000000000000000000000000000000
000000000100000000000000000010
000000000000000000000100000000
000000000000000000100000010000
000010000000010100010010000000
000000000001100000000100001000
001000000000000000000000000000
010000011000000000000000000010
000100001010010100100000000100
001000000011010000100110010100
000000000000000000000000000000
000010010000000000000001001000
000010100000000000000000000000
100000000000000000100110011000
000010000000000000000000000000
000000000000000000000000000101
000000000000000000000000000000
000010000000010000100001000000
000010000000010000000000000000
000000000000000001000010010000
000000000000001000010000000100
101000000100100000000000000000
010000000100000010000000000000
100000000000000000000300000000
000000000000010000000100000000
000000001000000000000000000000
000000100000000000100000010000
010101001001000100000000000110
