2111001010
1011010110
1000010000
1011001000
1100111011
1110100000
1000010000
1011101100
0000000001
1000030110
