210101000000110010000000000000
000000110101011001001010001000
110000000001100100001000011001
000001000110010001000000000000
010000011010100101000010100000
100001000000011011111101001101
011000000000100101000001000010
000100000000100010001000000100
001000000000010001000001100001
000110000010000010000100010000
010000010011001000000011010000
000010001011000000000011010000
011100100011000001001111110000
000011000000011000111100000100
011011100101001010001000000010
100001001000001011000110000001
010000000011000000000110000010
100101001000101100110011003100
010101100000000000010100110001
110100100000000000011110001100
010001000100111011010000010110
011010000000110000010000000001
010001001100100000101110001001
110000000100000000101010011001
001000000110000000000000101100
000000110010000100001100100100
000010010110000011010011000011
111000001000001001100000100001
111100100111001000100000001001
000000011100000000010011101010
