2110001000
0000000000
0000000001
0000010000
0000000000
1000000000
0000000000
0000000003
0011000000
0100100000
