2000000000
0011000000
0100001000
1000011000
0000100000
0100110100
0000101001
0000000030
0001100000
0101000010
