2000010000
0001000000
0001100000
0000010000
0101000100
0000000000
0000000000
0000001001
0000000000
0000000003
