200000000000000000000000000001
000101000000000000000000100000
010000000000000000000000100111
000000000000000000000000000000
000000000000000001001000100000
000000010000000000000000000000
000000000000000000000000000000
001000000000001000001000000110
001000001001000000000000000000
010000000000000000000000000100
000000001001000000000000011000
000001000000100000000001110000
100001000000101001000001100100
000100001000000000000000000000
000000100000000010000000000001
000000100000100011001000000000
100100000000110000000000000001
000000000000000000000000010000
010000100000000000000000000001
000000000000000000000010000100
000010010000111000000000000000
000100000000000000010110000000
010000000000010000000001000000
000000000000000000000000011000
000000011100000000000000000000
000000000000010010000000000000
000000000000000300000000000000
000100010000000000000000000000
000000100000100001010001101000
000000000000000100000000000000
