2000000000
0000010000
0000000100
1110110100
1010110010
0000000100
0000000100
0010013000
0010000000
1000010000
