200000110000001000000000000000
010000001000000000000100110010
000000000000000000000000000000
000000000000100100010000000000
000000000011001000011100000000
100000000100001000010000000000
100000000000000000000000001001
000000100000001000100000010001
000100000000000000000000000000
000000000000000000100000000000
001000000000000100000000000000
000000000010100000000000000000
000000000000000010000000000000
000000010000000000000000100000
000000100000000100100000000001
010100000010000000000100000100
000000010000000000000000000000
000001001100000000000000000011
000000000000000000000100000000
000000000000000000000100000000
000000000000000000000001100000
000000001000000031000000000000
000000001000000100100001000001
010000010000000000000001000100
000000000000000000001000000000
100001001000000000000000000000
000010000000000000010000010000
000000010001010000000000100000
000000000011110000000100010000
000010110001000000000000000000
