2010100000
1011100110
0000111010
0100110010
0001100110
1000000003
0010010010
1011100110
0101000001
0111000011
