200000000000000000000010100000
000000010001000000000000000000
000100000000000000000001000101
000000100000000000000010010001
000000100000100000100000000000
010000000000000000000011010000
000010000000100000000000000000
101000000000000000000000000000
000010000000010000000000000000
001000000000010000000000010000
000000000100000000000000000000
000000000000010000000000110010
000000000000000001000000000000
000000000000000000100010000000
000010000000001000000000010000
011000100000000000000100000100
000000100001000000000000000010
001010000000000010000100110100
001001000000110030100000000000
000000000111000000000000000000
000100010000001000000000000100
000000000000000000000010000000
000000001000000000000000000000
000000010000000000000000100000
000000000000000000000000000001
100000000101100000100100000000
100000000001000000100000000001
000000000000000110010001000000
000100000000000010001000000000
000010000000000000001000000000
