200000000001001100100001100000
001100101110101000001000000100
100011101000000101110001001110
000101000101000100000010001000
010111010000010111000000111000
000000100000001100010000000001
010101010100010010000100000001
111011100001100000100000000011
000110000000000110000000000111
010001001000000000110000001101
001100000100000000010101101000
001100001000110000000000100001
101100000100011000011000110000
100000000000100000100100011010
100000000100011000001100101101
001001010010001101000100010100
000000101100110100101100010000
100101110000010100100000111000
111000111000111010000001300100
100000000100010110000100001000
100100110000010000010111000001
001001000010001000100000000101
001000101001110001000001001000
100010000100000001001100001011
001110010010110010010010001010
001100000000000010101000000000
101000100000010100000000000110
100000001001100000101000100001
000101001100010010001000001010
101001010001101010010111001001
