200010000100100000000000000001
010000000000000000000000000000
000010000000000000000000000000
100000000000000000000000000010
000100000000000000000000000011
000000000001001000000000000000
010000000001011000000000000000
000000000000000100000001000100
000000000001001000000000000001
000000010000000000010010000001
001000000000100000000000011000
000000001000000010000000000000
000000000000000000000000000000
000110000000000000000000000000
000000000000000000000100000000
000000000000000001000000000000
000000000000000000000000000000
000001000000011111001030000101
000100010000000100100000100010
000000100000100000000000000000
100100000001011000000010100000
000001000000000000000000000000
000000001000010100000000001010
000000011100000000000000000100
000000010000011000100000000000
000000000001000010000000100100
000001000000000010110000100000
110000000000000010000000000000
100000000000000000000000000001
000000000100000000000000000000
