2001111010
0000001001
1100010110
0100001010
0011000111
0111011100
1011001000
1000100100
1111000100
0000000030
