2000000000
0010000000
0001001000
0000000100
0001000000
1000000000
0001000000
0000130001
1000000000
0000000000
