210000000000010000010010100010
011000000010010101000001111011
000110010001010010000100110100
000001100011000011000100000000
100001101001010101010001110010
100010000000001010000010110111
000010010010000001110001110001
001100100100100010010000000111
100100000101011001000010100000
001110001000000001101110010011
000100011100001100110011010000
010001001000010010001101000010
000000000000010000100000010000
010100000001000000000000010000
001000111110000110001101110110
011000100100000001110000101000
001110000100100000011000000000
000001000000000001011000000001
000010100001001010101000011000
001111001010001100000100100000
011100010100001000010000100000
001110000000001000001001000000
010111000001001000101010001000
000111000010001000110001000000
100001000110010000000000100111
001100010000100100010311100110
111101001101001101010000000001
000000010100000000101100000000
000000010001010110001001000000
001000111100011110100000000101
