2001000001
1010000100
0000000001
0000001001
0001010001
1001000000
0000000001
0100000001
0000001130
0000001001
