2000000000
0010001110
0010000001
1000001100
0000001000
1010100010
0000000010
0000030000
0010000010
0001001010
