2100010101
0111010000
1100101110
0000001110
0000010000
1000000100
0000111100
1011111101
0100100011
0011101003
