200000000000000000001000000000
100000001000011000000000101000
000010100001000000010001011010
000000100100000000000010000110
001000101111000100100000001100
000000000001000000001100001101
000100110010001001100001000000
000000000110000001011000010011
010000000100000000000100100000
011111100010000001010101000000
000000100111100100101000001000
111000111011001010000110100001
010010000100011110100100001001
001101000011010100100000000100
011010011110100100000000000110
010100000101110110010011011010
001011000010100000011001011000
000010101110010000000001101013
100000000010000010100000010100
000110010100010000101001000000
010110000100010110000111001110
100001111011001000001111000001
000111110100110000100010001010
110000000001101000100111110010
000100110000000101001110000011
101000010100100001000000001101
000001010100000000110000000011
000000100010011010000100100011
010010000100010001100010000100
010001000001010100001000001100
