200000000000001010001011010100
000000000010000100000110111000
000000000100101011000000100100
000000010110110000110111000000
010100000001010000010010000010
001100000100000100000000110100
000010010000111000000101010001
001010000011000100001000101000
011010000000001000001000111001
001000110010100010010000000000
100001000000011101000001101000
001000000001000100000000001000
001000001000000010000001100000
110101000010100100100101011010
000000011101000000000010001011
011010010010100000110101010100
000011000001110310001000010010
001000101110000100010011010000
001010010000010010000011010000
100101100010000110010000000110
000000000100111011000100010101
000110001010000001001001010110
000000011000100010010000000000
100010000010011000010000011011
100000011101101010000100100100
001011001010010101100010110000
100010001000000000101000010010
010000000000101100000110010100
010001000000000100100001000001
000000100001000001000010111101
