210010001101010100000010000010
010000100000000001100010010000
100100100110001010000000100010
111000110010010100011000100111
000101000000101100111011001100
100100000100100010000010100000
001000010100001000100010001000
010000001111000001001000000001
000010000001101000111010101000
100001011110110100011011000000
000000000000000011000000000000
001011011000000000000010000000
110101100101001000010110111000
110000000000011111101000000010
101001000110100001001010000000
000110100000010000001010000000
100111100100001001011000001010
000000000000100110010000101010
101001001000000001010100100000
000111001000001113011010010000
011000100010000011010001001000
001100000000100100100100100110
110000100000010010000110101101
011000000100000011110110000000
010110110101000000100001001000
000000010100010111001010110000
011110000101101010001001101000
010000101000000100000000100110
100101010010000000100000000100
100000001000000000100100000100
