2000000010
0000000000
0100000000
0000001000
0000000000
1000100000
0000000001
0010030001
0000001000
0000000010
