200000000000000011111010000010
111110000000010001010101100100
110010110000001101001010000010
101110000010011000010001100000
000100000000001110100000000100
100010011000100001000011000011
010000010011100100011001000001
100111000000111111100000001010
101100000011011011010000100100
000100001001001001100101101000
001000010100000000011000010000
010100001010000010100000010000
101000000001001011000101001000
100000010110001000000110100001
100000000110000010000001000000
001010111010010000000101110101
110000000000100000001003000001
000000100000111011010000000000
101001000000010011001000000010
000000000000000100100000010110
101010010111001100100100101001
001100001100111110000010010000
000000000000000001010101010001
000010011000000010000100100000
001000010101010010100100110100
000011001011000101001110110010
000000100000100000000000000101
000011011000000001111100001100
000001101011000001010000000001
010011000011011000100001001000
