2100000000
0000001000
0000000000
1000101000
0001100000
0100000001
0010130110
0001100000
0000001110
0000000101
