21000001110100100101111111011
110101111110000111111101111111
011100011010011111111111111111
111101011101101111011111101011
011100000001110111101111011110
010111001101111001101110000111
001110110101011110110011000010
001011110101111100000010110101
111101011101111101111111101000
111011110100111100001111111011
111011111101110100001001111111
101110101100111011100111101000
111111011000101111111101111010
101111001101101110101111010110
111010100101101001111111111100
111100011011001011001010001011
111111110101101110101110111011
100101001100000000010101001111
111101111111010110010000101100
111011110111111111011011001111
011011111101011001010101100111
101111111111111111011111001011
111110101110110011000111100010
101111111111100111010101101101
011111110110110110010100000011
011111011010101011000000030111
011111111110111111111111101111
111111001110110011111001011110
110110110110111111011111011000
110110110111110101111111111101
