210100000000001100000000000000
010000000000000100000000001000
000000010000000000110000000000
000000000000000000000000000100
010000010010000000000100000110
000000000000000000000000000000
001000010000000000000000010000
010000000000000010000001000000
001000000001000001000000000000
010000000000100001011000100000
000010000000000000000000000000
000000110000100000000000000010
000000010000000000000000000000
000000001000010000001001001100
000000001100000000000001000000
000000000001000000100000010100
000000000000010101000000100000
000000000000000000100001000000
000000000000000000000100000030
000000000000000000000000000000
000000110000000001000101000000
010011000000001010000000000000
000000000000000000000000000000
000001010000100100000000000000
100000100000001011000100001000
000000011000000000100000000000
000000011000000000000000000000
000000010000000000000000100000
000000001000000000000000000000
010010000000001000000000000000
