2011100001
0110100001
0000011000
1111110010
0000001010
0111011111
0100100000
1011031001
1000010010
0110010000
