200000000000000000000000010001
001000000110000010001000000000
000000000000000000000000000000
000000001010000000001100100010
000100000010010100000000011001
000000000000000011000000000001
000000001100100000000000010000
000000010000000000010000000100
000000000000000000000000000000
000000000000000000000001000100
000011010000000010100000000000
000000000101000001000001010000
000000000000000000011000000000
000000000000100100000011000000
000000000000000000100000000001
010000000100100000000000010000
000001000000000000010000001000
000001001100000000000010000000
100000000000000000000000000000
000001000000000100010000000001
010000000000000100000000000000
010000000000001000010000000000
000000000000000000000010001000
001000000000000000000000000010
000100000100000100010000000100
000001000001000000001000000000
010000000000000000000000000010
000000010000100000000000000000
000000000100000000000013000000
000000000000001000000000000000
