2011010000
0000000000
0000000001
0000100000
1000001000
0000100000
0000000000
0001100000
0000003000
0000000000
