2000000000
0000000001
0000000001
0000000000
0010000000
0001000000
0000010000
0000000000
0000100010
0110010030
