200010100000100000010000000011
010100000011000000000000000000
000000000000001000000000100001
000010000000000100000010000000
000000000000000000100000000000
000000010100000000000000000000
010000001000000000011000000000
001100000101000000000001001000
000000001010000000000100000000
000100000001000000001000000000
100000010000000000010000000000
000000000001010000000000000010
100000010000000000000001000010
000000100000100000000000000000
000000100110000010000000100000
001000001000001000000000000000
000000000000000000001000000001
010000000000000000000000010000
100000000000000000001000000000
100000000000000000001000000000
010100000100010000000000000001
000010000000000000000001001110
000000000000000000000003000000
000000000000000000000000000000
000000000010000000000100000000
000000100001000000000000100011
011000000000001001000000100000
000000000000000000000000000000
010000000000000000100000010100
000000000000000000000010000000
