200000000000000000000000110100
010000000000000100001110010001
100111101000010000000101011101
101100000010110001110110000001
011000000001000100110001110011
100000000101110010000000011110
000001000110001101000000101000
100100100010001101000000100010
000110100100100001000110000010
010010101110100100000010000000
000000001011001010010011101110
000100000001000010000100100010
100001001000100100001010110000
000010110000110110001000000000
000100000000001000010000001101
011000000010101000010001111010
110011011001000000011010001010
010010110010001000001000000000
110001100100100010100000000000
001010010000100111000000010000
010101010001101001100100001010
101000001001000000110100100010
101000110000011111001000101000
100001001010010011000000001000
000100101000000000010000001100
011110000000010010000010001000
000100010010010001000100000100
010000000010010101011000000000
000000000100111000000010101030
001101001001000110010100011001
