2010010100
1000000000
0001100000
0000101100
0000000100
0010000000
0011100110
0100010000
0010000003
0000001000
