200000100000000000001000000000
000010100101000000000000100100
000000000000000000010010100000
000110000100000000001000000100
000000110000000000000001010100
100000000000000100000000000000
011000000100001000000000100100
000000000000000000000000000000
000000001000010000010000000000
010000100000000000000001100000
100000000000000000000000000100
000000100000000000000000000000
000000000000000000001100000100
000000000000101000000000000100
000010000000100001000000000000
000010000010000000000000000000
000000000000000000010000010000
010000000000000000000010000100
000001000100000000010000000100
000000001000001000000000000000
000000000000001003001000000000
010000000000010001000000000000
000000100000000000000010000000
000000000100000000000000000000
000000100001000000000000000011
010010001000001100000000000000
000000000000000000000000000000
010011000000010000100000000000
000100001000000000010000001000
000001100000000010000000000000
