211000000001110001010010110100
010011011000001001000001100100
011011010010001001000000010000
010000000010011000011000100110
010010010000001000001101000010
101000100000010000000101100010
100001010001100000010000001110
110001000100011000010010000011
010001011000000110000000010010
000001011100000000000000001000
110000011011000010001100000010
000000000100011010100100100010
001000010000110010001001100110
001001110000101101000000010101
100000010000000110100000011110
000110100000000010000100000001
011000000010001100001011100100
000001000010000010011100000001
000000011111100110110001001101
110101000001010001110000010110
000001000100011100000000100101
000000001010010011000000000000
001100101001001000111101010000
111100010100000100011010011001
011010000001000101000111000001
100000011000101010001000001100
111011000001000110001000000030
100000110010000000001000011110
100000101000000000000010001000
000000010000010010000010000110
