2001110000
0100000111
0001001110
0110010001
0100110010
0110111000
1000000101
1100001010
1111000003
1001010101
